R 500 500
NO ./texture/wall_texture/wood_wall.xpm
SO ./texture/wall_texture/wood_wall2.xpm
WE ./texture/wall_texture/dalles.xpm
EA ./texture/wall_texture/red_brick.xpm
S ./texture/sprite/fire.xpm
F 0,255,0
C 0,245,255

11111111111111111111111111111
12000000010000000000000010001
10021121000201010101001002101
10110000111111111111012211101
10200110000000000000021000101
10111111111011111111111100101
10000012001000000000000000101
11111001101111120211111111201
12221100101200010000000000001
10001020102111011111111111021
10101000100000000000000000011
10102221101111011111111111101
1N100000001200000000000000001
11111111111111111111111111111
